Estructura de directorios
ajax -- contiene código Ajax
classes - contiene las clases a utilizar
config -- contiene todo tipo de configuración
report -- contiene los reportes
images -- contiene imagenes de la aplicación
styles -- contiene el css
templates - contiene los templates de PDF
javascript - contiene todo codigo Javascript aplicado
development - contiene el codigo html/php
library - la idea es que contenga la libreria que arma los datepicker (Calendarios)
scriptsBD - scripts de base de datos

prueba bd
http://localhost/workspaceProgWebII/TPFinal/development/testConeccionBD.php

............ nueva linea



Clave para los commits: aC9Bm8Qu3Yp9

prueba 
http://localhost/workspaceProgWebII/TPFinal/development/formulario_de_vuelo.php

Modelo de datos

Estados de una RESERVA
	CON=Confirmada
	LE=Lista de espera
	P=Pagada
	CAN=Cancelada
	
Estados de un PASAJE
	P=Pagado
	C=Cancelado
	
Estados de un ASIENTO
	A=Asignado
	L=Libre

Estados de un VUELO
	COM=Completo
	INC=Incompleto